#################
#               #
#               #
#              ###
 #            #   #
 #            #   #
 #             ###
  #             #
  #           #####
  #           #   # 
   #          #   #
   #            
   #            
    #           
    #          
    #          
     #
     #
     #
###################